###################################################
#...#...#...#.#...............#...#.....#.#...#...#
#.###.#.###.#.###.###.#.#.#.###.#.#.###.#.#.#####.#
#.....#.#.......#.#.#.#.#.#.#.#.#.....#...........#
#.#.###.#####.#####.#.#####.#.###.#.#.###.#####.###
#.#...#...#.#.#.#.#...#.#.#.....#.#.#...#...#.....#
#####.###.#.#.#.#.#####.#.#.#.###.#######.#####.###
#...#...#...#...#.......#.#.#...........#...#.#.#.#
#.#.#.#.#######.#.#####.#.#.#####.#.#####.#.#.###.#
#.#...#.#.#.#.#.#.#...#.#.#...#...#...#...#.#.#...#
#.#######.#.#.#.###.#.#.#.#.#.###.###.#.#.###.###.#
#.....#.....#.#...#.#...#.#.#.#.#.#...#.#.....#...#
#.###.#.#.#.#.#.#######.#.###.#.###.#####.#####.#.#
#.#.#...#.#.........#.....#...#.......#.#.#.....#.#
#.#.#######.#####.###.#######.#####.#.#.#.#.#.#####
#.....#.....#.....#.#.#.......#...#.#...#.#.#.....#
#.###.#.#####.###.#.#.#.#.###.#.#####.#.#####.#.###
#.#...#.....#.#.#.......#.#.#.......#.#...#...#...#
#######.#####.#.###.###.#.#.#####.#.###.###.#.#####
#.#...#.#.#.#.....#.#...#.#.......#.#.....#.#.....#
#.###.###.#.#######.#######.###.#########.#.###.###
#.......#.......#.#.#.#.#.#.#...#.....#.#...#.....#
#####.#####.#.###.#.#.#.#.###.#.#####.#.#########.#
#...#...#...#...#...#.........#...#.............#.#
###.#.###.#########.#############.#.#.#.#.#.#.###.#
#.#.......#...#.#.....#.......#...#.#.#.#.#.#...#.#
#.#######.#.###.#####.#.#.#.#####.#.#.###.#########
#.....#...#.........#.#.#.#...#.#.#.#.#...#...#...#
###.###.#.###.###########.###.#.#.#.###.###.#####.#
#.....#.#.....#...........#.#.....#...#.#.....#...#
#####.#.#.#.#.#.###########.#.###.###.###.#####.###
#.......#.#.#...#.#...#.#.....#.........#.........#
#####.#######.#.#.#.###.###.###.#.###.###.#####.#.#
#.........#.#.#...#...........#.#.#.#.....#.....#.#
#.###.###.#.#.###########.#.###.#.#.#.###.#.###.###
#...#.#...#.#...#.....#.#.#.#...#...#.#.#.#.#.#...#
#.###.#####.#.#####.#.#.#####.#####.###.#####.###.#
#.#.........#.#.#...#...#.........#.....#.....#.#.#
#.#.#.#####.#.#.#####.#.#######.#######.###.###.#.#
#.#.#.....#.#.....#...#.#...#...#.....#...#.#...#.#
#.###.#######.###.#.#####.#.#.###.#.#######.#.#.#.#
#.#.#.#.........#...#.....#.#.#...#.....#.....#...#
#.#.###.#.###.#.###.#.#########.###.#####.#.#.###.#
#...#.#.#...#.#.#.#...#.........#.#.#...#.#.#.#...#
###.#.###.###.#.#.#.###.#.###.###.#.#.###.#.#####.#
#.#.#.#...#...#...#...#.#.#...#.#...#...#.#...#...#
#.#.#.###.#####.#.#####.#######.###.###.#.#######.#
#.....#.....#...#.#...#...#.....#.#...#...#.......#
#.#.#.#####.#.#####.#####.#####.#.#.#####.#######.#
#.#.#...#...#.......#.....#...................#...F
#################################################FF
