###########
#.........#
#.#.#####.#
#.#.#.....#
###.#.###.#
#...#...#.#
###.#####.#
#...#.#...#
#.#.#.#.#.#
#.#.#...#.F
#########FF
